################################################
#..............................................#
#..............................................#
#..............................................#
#..............................................#
#..............................................#
#..............................................#
#..............................................#
#..............................................#
#..............................................#
#..............................................#
#.....##########################################
#..............................................#
#......................#.......................#
#......................#.......................#
#......................#.......................#
#......................#.......................#
#......................#.......................#
#......................#.......................#
#......................#.......................#
###########################################....#
#..............................................#
#..............................................#
#..............................................#
#..............................................#
#..............................................#
#..............................................#
#..............................................#
#..............................................#
#....###########################################
#..............................................#
#..............................................#
#..............................................#
#..............................................#
#..............................................#
#..............................................#
#..............................................#
#..............................................#
#..............................................#
#..............................................#
#..............................................#
#..............................................#
#..............................................#
#..............................................#
#..............................................#
#..............................................#
#..............................................#
#..............................................#
################################################
