#####################################################################
#...................................................................#
#######.............................................................#
#...................................................................#
#.###################################################################
#.......................................#...........................#
#.......................................#...........................#
#.......................................#...........................#
#.......................................#...........................#
#.......................................#...........................#
#.......................................#...........................#
#.......................................#...........................#
#.......................................#...........................#
#.......................................#...........................#
#.......................................#...........................#
#.......................................#...........................#
#.......................................#...........................#
#.......................................#...........................#
#...................................................................#
#.......................................#...........................#
#.......................................#...........................#
#.......................................#...........................#
#.......................................#...........................#
#.......................................#...........................#
#.......................................#...........................#
#.......................................#...........................#
#.......................................#...........................#
#.......................................#...........................#
#.......................................#...........................#
#########################################...........................#
#...................................................................#
#...................................................................#
#.###################################################################
#...................................................................#
#...................................................................#
#...................................................................#
#...................................................................#
#...................................................................#
#...................................................................#
#...................................................................#
#...................................................................#
#...................................................................#
#...................................................................#
#...................................................................#
#...................................................................#
#...................................................................#
#...................................................................#
#...................................................................#
#...................................................................#
#...................................................................#
#...................................................................#
#...................................................................#
#...................................................................#
#...................................................................#
#...................................................................#
#...................................................................#
#...................................................................#
#...................................................................#
#...................................................................#
#...................................................................#
#...................................................................#
#...................................................................#
#...................................................................#
#...................................................................#
#...................................................................#
#...................................................................#
#...................................................................#
#...................................................................#
#...................................................................#
#####################################################################
